Внутренний перевод на договор 8199515993	 Сберегательный счет
Внешний банковский перевод на счёт	Квартира
Оплата в Delivery Club Moscow RUS	Delivery Club
Оплата в Apteka Gorzdrav MOSKVA G RU	Аптека
Внешний перевод по номеру телефона +79851721900	Антоха
Оплата в Yandex.Market Moskva RU	Yandex Market
Оплата в SBERMARKET Gorod Moskva RUS	SBERMARKET
Оплата в Delivery Club Moscow RU	Delivery Club
Оплата в MSKAPT 1492 MOSCOW RUS	MSKAPT
Внешний перевод по номеру телефона +79831123953	Настя
Оплата в GOLD APPLE EKATERINBURG RUS	Золото яблоко
Оплата в EKATERINBURG YABLOKO Gorod Moskva RUS	Золото яблоко
Оплата в POS MIMOZA MOSCOW RUS	Столовая
Внешний перевод по номеру телефона +79244230810	Себе на Альфа Банк
Оплата в OKEY Gorod Moskva RUS	OKEY
Оплата в VODNY STADION MOSCOW RUS	Тройка
Внутренний перевод на договор 5465455276	Наташа
Оплата в YM*DRIVE Gorod Moskva RUS	Яндекс драйв
Оплата услуг mBank.MTS	MTS
Оплата в MOSKVICHKA Gorod Moskva RUS	Парикмахерская
Оплата в EDINAYA BILETNAYA SIST MOSCOW RUS	зоопарк
Оплата в wildberries Podol'sk RU	wildberries
Оплата в PYATEROCHKA 19857 Gorod Moskva RUS	Пятерочка
Внутренний перевод на договор 5106983603	Антоха
Оплата в POS MIMOZA MOSCOW RU	Столовая
Оплата в CLUB EMPIRE Gorod Moskva RUS	Бильярд
Оплата в Whoosh.bike Moskva RU	Самокат
Оплата в KAFE GRACE PIZZA Gorod Moskva RUS	перекус
Оплата в VKUSVILL_KSO 4700_2 Gorod Moskva RUS	Вкусвилл
Оплата в Apteka 36,6 MOSKVA G RU	Аптека
Оплата в Moscow Central Circle MOSKVA RUS	Метро
Оплата в SHABOLOVSKAYA MOSCOW RUS	Метро
Оплата в POST RUS.SERVICE.12513 MOSKVA RUS	Почта
Оплата в WILDBERRIES.RU MILKOVO D. RUS	wildberries
Оплата в OAO Centralnaya PPK Schelkovo RUS	перекус
Оплата в POST RUS.SERVICE.125130 MOSKVA RU	Почта
Оплата в Yandex.Drive_GIBDD Moskva RU	Яндекс драйв
Оплата в DONER BISTRO MYASNITSK MOSKVA RU	перекус
Оплата услуг mBank.MegaFon	Мегафон
Оплата в IP BIZIN MAKSIM ALEKSE MOSCOW RUS	BIZIN MAKSIM
Оплата в YM*YANDEX.PLUS Moscow RU	Яндекс Плюс
Оплата в SP_STUDIYA CVETOV Gorod Moskva RUS	Цветы
Оплата в KRASNOE&BELOE Shhlkovo RUS	Краное белое
Оплата в ENA Shhlkovo RUS	перекус
Оплата в MAGNOLIYA264 Moskva RUS	Магнолия
Оплата в Urent Yessentuki RU	Самокат
Оплата в ZOOPARK 2 Gorod Moskva RUS	перекус
Оплата в KRASNOE&BELOE Gorod Moskva RUS	Краное белое
Оплата в PYATEROCHKA 10131 Shhlkovo RUS	Пятерочка
Оплата в MAGNOLIYA Gorod Moskva RUS	Магнолия
Оплата в AO Centralnaya PPK Moskva RUS	Centralnaya PPK
Оплата в DIXY-77555D Gorod Moskva RUS	Дикси
Оплата в PEREKRESTOK NOVOPETR B Gorod Moskva RUS	Перекресток
Оплата в ST7702118 MEGAFON Gorod Moskva RUS	Мегафон
Оплата в YM*yandex.plus g. Moskva RU	Яндекс Плюс
Проценты на остаток	Проценты на остаток
Возврат средств по операции оплаты Delivery Club	Delivery Club
Кэшбэк за покупки по акциям	Кэшбэк
Кэшбэк за обычные покупки	Кэшбэк
Отмена операции оплаты Delivery Club Moscow RU	Delivery Club
Пополнение. Сбербанк Онлайн	Со сбера
Отмена операции оплаты SBERMARKET Gorod Moskva	SBERMARKET
Возврат средств по операции оплаты GOLD APPLE	Золото яблоко
Внутрибанковский перевод с договора 5106983603	Антоха
Отмена операции оплаты Delivery Club Moscow RUS	Delivery Club
Внутрибанковский перевод с договора 5465455276	Наташа
Внутрибанковский перевод с договора 5347132143	кто-то перевел
Внутрибанковский перевод с договора 8199515993	 Сберегательный счет
Пополнение. Система быстрых платежей	Какие-то переводы
Внесение наличных через банкомат Тинькофф	Внесение наличных через банкомат Тинькофф
